1111111111111111
1C00001100010C11
1111101001010111
10000000110001C1
10101111P1100101
101C10E100101101
1011101110101001
1001000000100011
110001001C1010C1
1111111111111111