1111111111111111
11C0111111E110P1
11101000C1010011
10000011110101C1
1111000110000001
1C11000000001111
1001101100100001
11010001011101C1
1100010000000001
1111111111111111