1111111111111111
1000000001101111
100111110C000101
1000010011P01001
111011100C011001
11100010E0011101
1100111000000001
1110000010011111
1111111111011111
1111111111111111