1111111111111
1000P0000C001
10001E0000001
11101C0111001
10001100C10C1
1100C00001111
11C10000000C1
1111111111111