11111111
100C1001
100EC001
10P00001
11111111