11111111
1000P001
10000E01
10000C01
11111111